{
  "id": 5,
  "name": "Broken Causeway",
  "difficulty": 5,
  "category": "core",
  "description": "A broken causeway with several direction changes. Shortest: 25 moves.",
  "grid": [
    "#####################",
    "#####################",
    "#######...###########",
    "##S.......###########",
    "#####..##.###########",
    "#####..##...#########",
    "#########...#########",
    "#########....###G####",
    "#########....###.####",
    "############...#.####",
    "#############......##",
    "################...##",
    "################...##",
    "#####################",
    "#####################"
  ],
  "legend": {
    "#": "void",
    ".": "floor",
    "S": "start",
    "G": "goal"
  },
  "bridges": [],
  "switches": [],
  "split": null
}