{
  "id": 7,
  "name": "Island Maze",
  "difficulty": 7,
  "category": "core",
  "description": "A larger island-like maze with dead ends. Shortest: 29 moves.",
  "grid": [
    "######################",
    "######################",
    "################S...##",
    "################....##",
    "################....##",
    "##################..##",
    "##################..##",
    "###################.##",
    "###############.....##",
    "##.........####.....##",
    "##......#.......######",
    "##G##...###..#########",
    "###########..#########",
    "######################",
    "######################"
  ],
  "legend": {
    "#": "void",
    ".": "floor",
    "S": "start",
    "G": "goal"
  },
  "bridges": [],
  "switches": [],
  "split": null
}