{
  "id": 6,
  "name": "Spiral Descent",
  "difficulty": 6,
  "category": "core",
  "description": "A winding route with a distant goal. Shortest: 25 moves.",
  "grid": [
    "###################",
    "###################",
    "##############...##",
    "##############...##",
    "##############.#S##",
    "##############.####",
    "##############.####",
    "########.......####",
    "#######...###..####",
    "#######.#####..####",
    "##G#......#########",
    "##...##...#########",
    "##...##############",
    "###################",
    "###################"
  ],
  "legend": {
    "#": "void",
    ".": "floor",
    "S": "start",
    "G": "goal"
  },
  "bridges": [],
  "switches": [],
  "split": null
}