{
  "id": 9,
  "name": "Dense Labyrinth",
  "difficulty": 9,
  "category": "core",
  "description": "Dense corridors with many orientation traps. Shortest: 36 moves.",
  "grid": [
    "##############",
    "##############",
    "######...#####",
    "######...#####",
    "#####..#######",
    "#####..#######",
    "##G##S.#######",
    "##.###.#######",
    "##.###.#######",
    "##.###..######",
    "##.###.....###",
    "##.####....###",
    "##.#######.###",
    "##.#####....##",
    "##.##....#..##",
    "##.......#..##",
    "###......#####",
    "###...########",
    "##############",
    "##############"
  ],
  "legend": {
    "#": "void",
    ".": "floor",
    "S": "start",
    "G": "goal"
  },
  "bridges": [],
  "switches": [],
  "split": null
}