{
  "id": 8,
  "name": "Deep Zigzag",
  "difficulty": 8,
  "category": "core",
  "description": "A deep zigzag route designed for solver testing. Shortest: 36 moves.",
  "grid": [
    "##################",
    "##################",
    "#####...##########",
    "#####...##########",
    "###...#.##########",
    "###..##...########",
    "###..##...########",
    "##S..##...########",
    "#######..#########",
    "#######...########",
    "#########.########",
    "#########.####G###",
    "#########.###..###",
    "#########.###..###",
    "#########.###.####",
    "#########.....####",
    "#########..##.####",
    "#########..##...##",
    "#############...##",
    "##################",
    "##################"
  ],
  "legend": {
    "#": "void",
    ".": "floor",
    "S": "start",
    "G": "goal"
  },
  "bridges": [],
  "switches": [],
  "split": null
}