{
  "id": 10,
  "name": "Final Core Challenge",
  "difficulty": 10,
  "category": "core",
  "description": "The hardest core-only level in this set. Shortest: 40 moves.",
  "grid": [
    "#####################",
    "#####################",
    "#################G###",
    "#################..##",
    "####....#########..##",
    "####....########...##",
    "####.##....S####..###",
    "##......##..#.....###",
    "##...#......#..######",
    "##...#..##.....######",
    "######..#############",
    "######..#############",
    "######..#############",
    "####....#############",
    "####...##############",
    "#####################",
    "#####################"
  ],
  "legend": {
    "#": "void",
    ".": "floor",
    "S": "start",
    "G": "goal"
  },
  "bridges": [],
  "switches": [],
  "split": null
}